1111111111111111111
100000111010E0E0001
11111100000000C0001
10C00000100P0010001
1C11000010000E00001
1111111110111111111
1000000000000C00011
1000V00000000C00011
10000000V0000C00011
1000V00000000C00011
1000000000000C00011
1000000000000C00011
1111111111111111111