1111111111111111111
100000000000EEE0001
100000000000C000001
10000000000P0000001
1000000000000000001
1111111111111111111