1111111111111111111
100000111010E0E0001
11111100000000C0001
10C000V0100P0010001
1C110V0010000E00001
1111111111111111111