1111111111111111111
1000000000000000001
1000000P110000C0001
10001000000E0000001
1111111111111111111