1111111111111111111
1000000000000000001
1000000P0000000C001
10000000000E0000001
1111111111111111111