11111111111111111111111111
10000000000000000000PC0001
10CE00V000E000000000000001
10CC00VV00EE00000100000001
10C000V000E000000000000001
10000000000000000000000001
11111111111111111111111111