1111111111
1000V00001
1000V000P1
10CCC01111
10000000E1
1111111111